111111111111111111
10c00001000000p011
101110000000000111
1001111111000p0001
100000000000000001
110000c000ce000001
111111100000000011
100000010c00000011
111111110000000011
111111111111111111