111111111111111111
10C0000100000P0011
101110000000000111
100111111100000001
100000000000000001
110000C000C0000001
111111100000000011
100000010C00000011
1111111100E0000011
111111111111111111