111111111111111111
10C000100000P00111
101110000000000111
100111111100000001
110000C000C0000001
100000011C00000011
11111111EC00000011
111111111111111111