1111111
100C011
1E1P111
1111111