1111111
100C111
1E1P111
1111111