1111111
100C011
1E1P1P1
1111111