1111111
10C0011
1E1P101
1111111