1111111111
100P000001
1C0011E001
1111111111